approach - подход/метод, приближение/сближение
implement - осуществлять, воплощать в жизнь
large - большой/крупный, значительный
instead - вместо, взамен, наоборот/напротив
rear - тыл/задняя сторона/задняя часть
crucial - ключевой/критический/решающий
toehold - точка опоры
wide - широкий/обширный/большой
width - ширина
fiber - световод, волокно/волоконный
pattern - структура/форма, шаблон, образец, пример
template - шаблон/образец/модель/лекало
etch - травление/протравливание
anneal - обжигать/обжечь
however - как бы ни/какой бы ни, однако/тем не менее
rival - соперник/конкурент
among - среди, из числа/в числе
rely - полагаться/доверять/опираться
such - такой/такие
thus - так/таким образом
explain - объяснять/разъяснять
each - каждый/всякий
make - делать/совершать
average - средний/среднее
duration - продолжительность/длительность/длина
sudden - неожиданность, внезапный/неожиданный
demand - спрос/потребность
endure - терпеть/переносить/стерпеть/устоять
almost - почти, едва не
filament - нить/волокно/ниточка
some - некоторый, несколько
prevent - предотвращать/не допускать, препятствовать/мешать
tiny - крошечный/очень маленький
circuit - цепь/схема/контур
compatible - совместимый/сочетаемый
serve - служить/работать
require - приказывать/требовать, нуждаться
feature - особенность/свойство/характеристика, характерная черта
previous - предыдущий/прежний, предварительный
success - удача/успех/благоприятный исход
enable - включать/активировать, давать возможность/позволять
while - пока, в то время как, время/промежуток времени/некоторое время
imply - подразумевать/предполагать/значить
occur - происходить/случаться/иметь место
arbitrary - произвольный/случайный/условный
case - случай/обстоятельство
exceed - превышать/превосходить/выходить за пределы
differ - отличаться/различаться, различный/разный
reason - причина/повод/мотив, довод/резон/аргумент
either - оба, любой (из двух), один из двух/тот или другой
ratio - отношение/коэффициент/соотношение/пропорция
compare - сравнивать/сопоставлять
even - даже/еще/хотя бы, ровный/равномерный/гладкий
depend - зависеть/полагаться, зависимый
suffice - хватать/быть достаточным, удовлетворять
dissipate - рассеивать/растрачивать/расточать/проматывать
propose - предлагать/выдвигать, представлять
percolate - просачиваться/проникать
reveal - раскрывать/разоблачать, открывать/обнаруживать
near - близкий/ближайший
far - далекий/дальний/отдаленый
height - высота/вышина
supply - поставка/подача/подвод, питание, снабжение
define - определять/характеризовать
merit - заслуга, достоинство/преимущество
crease - складка/сгиб/морщина/изгиб
increase - увеличение/повышение/расширение/усиление
decrease - уменьшение/понижение/сокращение/ослабление
certain - определенный/отдельный/конкретный, точный
urge - убеждать/уговаривать/побуждать/призывать
exist - существовать/жить
significant - значительный/важный/существенный
simple - несложный/простой/легкий
benefit - выгода/прибыль/преимущество/польза
prove - доказывать/показывать/подтверждать
improve - улучшать/совершенствовать/поправить/оздоровить
actual - фактический/реальный/действительный
vary - варьировать/изменяться/менять, различаться/отличаться
simile - сравнение, притча/метафора
attract - привлекать/притягивать/манить/заинтересовывать
wise - мудрый
hinder - препятствовать/мешать/затруднять
in order to - для того, чтобы
attempt - попытка/проба
try - пытаться/стараться, пробовать/опробовать
recent - последний/недавний, новейший/современный
pass - пропуск, проходить/переходить/пройти
prefer - предпочитать/отдавать предпочтение
essence - сущность/эссенция/суть/смысл
overlap - перекрытие/наложение/совмещение
depth - глубина
pure - чистый/безпримесный
plenty - изобилие/обилие/достаток
deplete - истощать/исчерпывать
consume - потреблять, тратить/расходовать
clamp - зажим/хомут/скоба, клемма
saturate - насыщать, пропитывать
avoid - избегать/предотвращать/сторониться/уклоняться
care - осторожность/тщательность/внимательность
residue - остаток/осадок/отстой
lead - приводить/вести, руководить/управлять
adopt - усваивать, принимать/утверждать
accept - принимать/брать, соглашатьсь/признавать
pair - пара
poor - бедный/малоимущий
uniform - равномерный/однородный
temporal - временный, переходящий
spatial - пространственный/территориальный
origin - источник/начало, происхождение/зарождение
attribute - характерная черта/неотъемлемое свойство/атрибут
sever - отделять/разделять/обрывать
severe - строгий/суровый, требовательный
effort - усилие/старание, попытка/стремление
expend - тратить/расходовать/затрачивать
confine - ограничивать/заключать
corner - угол/уголок
angle - угол
extend - расширять, продлевать, удлинять, распространять
verify - контролировать/проверять/удостоверяться
sad - печальный/грустный/унылый
refuge - убежище/прибежище/приют/пристанище
riot - бунт/мятеж/восстание/погром
might - мочь/смочь, мощь/сила/могущество
prosper - процветать/преуспевать/благоденствовать
proof - доказательство/подтверждение/улика/свидетельство
soak - впитывать, пропитывать, просачиваться
dense - плотный/густой/сжатый
below - внизу/ниже
above - над/выше
before - до/перед
after - после/за
beyond - за/по ту сторону/за пределами
wish - хотеть/желать
desire - желание/стремление/хотение, страсть/вожделение/влечение
often - часто/зачастую/нередко/неоднократно
restroct - ограничивать/сковывать
limit - предел/лимит/ограничение
blank - бланк, заготовка/болванка, пустое место
sheet - лист/пластина
equip - снаряжать/экипировать/оснащать/оборудовать
access - доступ, подход/проход
place - место/положение/должность, размещать/помещать/ставить
convene - созывать/собирать/вызывать
allow - позволять/давать возможность/разрешать/пускать
acquaint - знакомить/ознакомить
along - вдоль/по, вместе/параллельно
adjust - регулировать/настраивать
ribbon - лента/ленточка, нашивка
until - до, то тех пор пока, не раньше, пока
deviate - отклоняться, отступать/отходить
flex - сгибать/изгибать/гнуть, гибкая труба
amount - величина/количество, итог/результат
size - размер/величина/габариты
magnitude - величина/значение/амплитуда
value - величина/значение, ценность/важность
capacity - вместимость/объем/емкость/производительность/мощность
aux - дополнительный, вспомогательный
accomplish - выполнять/совершать/достигать/выполнять
achieve - достигать/добиваться/достичь/получить
fulfil - выполнять/делать/исполнять/осуществлять
perform - исполнять/выполнять/делать/осуществлять
depict - изображать/рисовать, описывать/обрисовывать
describe - описывать/изображать/излагать
bottom - дно, низ/нижняя часть
button - кнопка
reach - достигать/добиться, доходить/простираться
row - ряд/шеренга, последовательность
column - столбец/колонка/графа
string - строка, ряд/последовательность, цепочка
expense - расход/издержка/трата
expend - расходовать/тратить/затрагивать
prompt - быстрый/проворный, подсказка
fuel - топливо/горючее
pour - наливать/лить/выливать/заливать
response - реакция/ответ/отклик
lattice - решетка/сетка
grid - сетка/решетка
mesh - клетка/сетка, ячейка сетки, зацепление
suffer - страдать/терпеть
template - шаблон/образец (подложка/основа)/модель
pattern - структура/форма/шаблон
shape - форма/очертание
constrain - сдерживать/ограничивать
route - маршрут/путь/трасса
path - путь/тропа/дорога/маршрут
way - путь/дорога, способ/метод
push - толчок/нажим
determine - определять/решать
define - определять/характеризовать
tweezer - пинцет
mention - упоминание/ссылка
kind - вид/род/тип/разновидность/сорт
consider - считать/полагать, рассматривать/учитывать
clash - столкновение/конфликт, сталкиваться
carry - нести/переносить/выдерживать, перевозить
robust - надежный/прочный/твердый, здравый
